0 0 0 6 9 13 14 16 20 21 22
0 0 2 6 9 13 14 16 20 21 22
0 0 4 6 9 13 14 16 20 21 22
0 0 6 6 9 13 14 16 20 21 22
0 1 0 6 9 13 14 16 20 21 22
0 1 2 6 9 13 14 16 20 21 22
0 1 4 6 9 13 14 16 20 21 22
0 1 6 6 9 13 14 16 20 21 22
0 2 0 6 9 13 14 16 20 21 22
0 2 2 6 9 13 14 16 20 21 22
0 2 4 6 9 13 14 16 20 21 22
0 2 6 6 9 13 14 16 20 21 22
3 0 0 9 19 23 27
3 0 1 9 23 27 28
3 3 0 9 19 23 27
3 3 1 9 23 27 28
3 6 0 9 19 23 27
3 6 1 9 23 27 28
5 2 0 9 19 23 27
5 2 1 9 23 27 28
5 5 0 9 19 23 27
5 5 1 9 23 27 28
5 8 0 9 19 23 27
5 8 1 9 23 27 28
5 11 0 9 19 23 27
5 11 1 9 23 27 28
7 1 1 7 10 11 12 18 19 28 31
7 1 3 7 10 11 12 18 19 28 31
7 1 5 7 10 11 12 18 19 28 31
7 1 7 7 10 11 12 18 19 28 31
7 2 1 7 10 11 12 18 19 28 31
7 2 3 7 10 11 12 18 19 28 31
7 2 5 7 10 11 12 18 19 28 31
7 2 7 7 10 11 12 18 19 28 31
7 3 1 7 10 11 12 18 19 28 31
7 3 3 7 10 11 12 18 19 28 31
7 3 5 7 10 11 12 18 19 28 31
7 3 7 7 10 11 12 18 19 28 31
8 11 1 7 10 11 12 18 19 28 31
8 11 3 7 10 11 12 18 19 28 31
8 11 5 7 10 11 12 18 19 28 31
8 11 7 7 10 11 12 18 19 28 31
8 12 1 7 10 11 12 18 19 28 31
8 12 3 7 10 11 12 18 19 28 31
8 12 5 7 10 11 12 18 19 28 31
8 12 7 7 10 11 12 18 19 28 31
8 13 1 7 10 11 12 18 19 28 31
8 13 3 7 10 11 12 18 19 28 31
8 13 5 7 10 11 12 18 19 28 31
8 13 7 7 10 11 12 18 19 28 31
11 7 0 9 19 23 27
11 7 1 9 23 27 28
11 10 0 9 19 23 27
11 10 1 9 23 27 28
11 13 0 9 19 23 27
11 13 1 9 23 27 28
13 2 0 9 19 23 27
13 2 1 9 23 27 28
13 5 0 9 19 23 27
13 5 1 9 23 27 28
13 8 0 9 19 23 27
13 8 1 9 23 27 28
13 11 0 9 19 23 27
13 11 1 9 23 27 28
15 10 0 6 9 13 14 16 20 21 22
15 10 2 6 9 13 14 16 20 21 22
15 10 4 6 9 13 14 16 20 21 22
15 10 6 6 9 13 14 16 20 21 22
15 11 0 6 9 13 14 16 20 21 22
15 11 2 6 9 13 14 16 20 21 22
15 11 4 6 9 13 14 16 20 21 22
15 11 6 6 9 13 14 16 20 21 22
15 12 0 6 9 13 14 16 20 21 22
15 12 2 6 9 13 14 16 20 21 22
15 12 4 6 9 13 14 16 20 21 22
15 12 6 6 9 13 14 16 20 21 22
